Aliases in git

alias.lg1=log --color --graph --pretty=format:'%Cred%h%Creset -%C(yellow)%d%Creset %s %Cgreen(%cr) %C(bold blue)<%an>%Creset' --abbrev-commit
alias.last=log -1 HEAD
alias.unstage=reset HEAD --
alias.co=checkout
alias.br=branch
alias.ci=commit
alias.st=status
alias.hist=log --pretty=format:'%h %ad | %s%d [%an]' --graph --date=short
alias.type=cat-file -t
alias.dump=cat-file -p
alias.amend=commit --amend -a
alias.ds=diff --staged
alias.di=diff
alias.log-fancy=log --graph --pretty=format:'%Cred%h%Creset -%C(auto)%d%Creset %s %Cgreen(%cr) %C(cyan)<%an>%Creset' --abbrev-commit --date=relative
alias.log-nice=log --graph --decorate --pretty=oneline --abbrev-commit
alias.logdate=log --pretty=format:'%h %cd [%an] %s' --graph --date=short
alias.logweek=log --pretty=format:'%h %cd [%an] %s' --graph --date=short --since=1.week
alias.logday=log --pretty=format:'%h %cd [%an] %s' --graph --date=relative --since=1.day
alias.logstat=log --pretty=short --stat --oneline
alias.logrev=log --reverse
alias.logr=log --reverse --oneline
alias.am=commit --amend
alias.ph=push
alias.ft=fetch
alias.pl=pull
alias.pr=pull --rebase
alias.le=log --oneline --decorate
alias.leg=log --oneline --decorate --graph
alias.filelog=log -u
alias.fl=log -u
alias.dlc=diff --cached HEAD^

Bash git aliases

alias g='git'
alias ga='git add'
alias gaa='git add --all'
alias gall='git add -A'
alias gap='git add -p'
alias gapa='git add --patch'
alias gau='git add --update'
alias gb='git branch'
alias gba='git branch -a'
alias gbd='git branch -d'
alias gbda='git branch --no-color --merged | command grep -vE "^(\*|\s*(master|develop|dev)\s*$)" | command xargs -n 1 git branch -d'
alias gbl='git blame -b -w'
alias gbm='git branch -m'
alias gbnm='git branch --no-merged'
alias gbr='git branch --remote'
alias gbs='git bisect'
alias gbsb='git bisect bad'
alias gbsg='git bisect good'
alias gbsr='git bisect reset'
alias gbss='git bisect start'
alias gbt='git branch --track'
alias gc='git commit -v'
alias gc!='git commit -v --amend'
alias gca='git commit -v -a'
alias gca!='git commit -v -a --amend'
alias gcaa='git commit -a --amend -C HEAD'
alias gcam='git commit -a -m'
alias gcan!='git commit -v -a --no-edit --amend'
alias gcans!='git commit -v -a -s --no-edit --amend'
alias gcb='git checkout -b'
alias gcd='git checkout develop'
alias gcf='git config --list'
alias gci='git commit --interactive'
alias gcl='git clone'
alias gclean='git clean -fd'
alias gcm='git commit -v -m'
alias gcmsg='git commit -m'
alias gcn!='git commit -v --no-edit --amend'
alias gco='git checkout'
alias gcob='git checkout -b'
alias gcom='git checkout master'
alias gcount='git shortlog -sn'
alias gcp='git cherry-pick'
alias gcpa='git cherry-pick --abort'
alias gcpc='git cherry-pick --continue'
alias gcs='git commit -S'
alias gcsam='git commit -S -am'
alias gcsm='git commit -s -m'
alias gct='git checkout --track'
alias gd='git diff'
alias gdca='git diff --cached'
alias gdct='git describe --tags `git rev-list --tags --max-count=1`'
alias gdel='git branch -D'
alias gdt='git diff-tree --no-commit-id --name-only -r'
alias gdv='git diff -w "$@" | vim -R -'
alias gdw='git diff --word-diff'
alias get='git'
alias gexport='git archive --format zip --output'
alias gf='git fetch'
alias gfa='git fetch --all --prune'
alias gfo='git fetch origin'
alias gft='git fetch --all --prune --tags'
alias gftv='git fetch --all --prune --tags --verbose'
alias gfv='git fetch --all --prune --verbose'
alias gg='git log --graph --pretty=format:'\''%C(bold)%h%Creset%C(magenta)%d%Creset %s %C(yellow)<%an> %C(cyan)(%cr)%Creset'\'' --abbrev-commit --date=relative'
alias ggpull='git pull origin $(git_current_branch)'
alias ggpush='git push origin $(git_current_branch)'
alias ggsup='git branch --set-upstream-to=origin/$(git_current_branch)'
alias ggui='git gui'
alias ghh='git help'
alias gignore='git update-index --assume-unchanged'
alias gignored='git ls-files -v | grep "^[[:lower:]]"'
alias git-svn-dcommit-push='git svn dcommit && git push github master:svntrunk'
alias gk='\gitk --all --branches'
alias gke='\gitk --all $(git log -g --pretty=%h)'
alias gl='git pull'
alias glg='git log --stat'
alias glgg='git log --graph'
alias glgga='git log --graph --decorate --all'
alias glgm='git log --graph --max-count=10'
alias glgp='git log --stat -p'
alias gll='git log --graph --pretty=oneline --abbrev-commit'
alias glla='git log --graph --pretty=oneline --abbrev-commit --all'
alias glo='git log --oneline --decorate'
alias glog='git log --oneline --decorate --graph'
alias gloga='git log --oneline --decorate --graph --all'
alias glol='git log --graph --pretty='\''%Cred%h%Creset -%C(yellow)%d%Creset %s %Cgreen(%cr) %C(bold blue)<%an>%Creset'\'' --abbrev-commit'
alias glola='git log --graph --pretty='\''%Cred%h%Creset -%C(yellow)%d%Creset %s %Cgreen(%cr) %C(bold blue)<%an>%Creset'\'' --abbrev-commit --all'
alias glp='_git_log_prettily'
alias glum='git pull upstream master'
alias gm='git merge'
alias gmom='git merge origin/master'
alias gmt='git mergetool --no-prompt'
alias gmtvim='git mergetool --no-prompt --tool=vimdiff'
alias gmu='git fetch origin -v; git fetch upstream -v; git merge upstream/master'
alias gmum='git merge upstream/master'
alias gmv='git mv'
alias gnew='git log HEAD@{1}..HEAD@{0}'
alias gp='git push'
alias gpd='git push --dry-run'
alias gpo='git push origin'
alias gpoat='git push origin --all && git push origin --tags'
alias gpom='git push origin master'
alias gpp='git pull && git push'
alias gpr='git pull --rebase'
alias gpristine='git reset --hard && git clean -dfx'
alias gpsup='git push --set-upstream origin $(git_current_branch)'
alias gpu='git push upstream'
alias gpv='git push -v'
alias gr='git remote'
alias gra='git remote add'
alias grb='git rebase'
alias grba='git rebase --abort'
alias grbc='git rebase --continue'
alias grbi='git rebase -i'
alias grbm='git rebase master'
alias grbs='git rebase --skip'
alias grh='git reset HEAD'
alias grhh='git reset HEAD --hard'
alias grm='git rm'
alias grmv='git remote rename'
alias grrm='git remote remove'
alias grset='git remote set-url'
alias grt='cd $(git rev-parse --show-toplevel || echo ".")'
alias gru='git reset --'
alias grup='git remote update'
alias grv='git remote -v'
alias gs='git status'
alias gsb='git status -sb'
alias gsd='git svn dcommit'
alias gsi='git submodule init'
alias gsl='git shortlog -sn'
alias gsps='git show --pretty=short --show-signature'
alias gsr='git svn rebase'
alias gss='git status -s'
alias gst='git status'
alias gsta='git stash save'
alias gstaa='git stash apply'
alias gstc='git stash clear'
alias gstd='git stash drop'
alias gstl='git stash list'
alias gstp='git stash pop'
alias gsts='git stash show --text'
alias gsu='git submodule update'
alias gt='git tag'
alias gta='git tag -a'
alias gtd='git tag -d'
alias gtl='git tag -l'
alias gts='git tag -s'
alias gtv='git tag | sort -V'
alias gunignore='git update-index --no-assume-unchanged'
alias gunwip='git log -n 1 | grep -q -c "\-\-wip\-\-" && git reset HEAD~1'
alias gup='git pull --rebase'
alias gupv='git pull --rebase -v'
alias gus='git reset HEAD'
alias gwc='git whatchanged'
alias gwch='git whatchanged -p --abbrev-commit --pretty=medium'
alias gwip='git add -A; git rm $(git ls-files --deleted) 2> /dev/null; git commit --no-verify -m "--wip-- [skip ci]"'
